"filename", "language", "C#", "comment", "blank", "total"
"d:\Projekty\RoguelikeGame - Praca Inżynierska\roguelike-game\Roguelike Game Project\Assets\Scripts\ArrowFallEvent.cs", "C#", 10, 21, 6, 37
"d:\Projekty\RoguelikeGame - Praca Inżynierska\roguelike-game\Roguelike Game Project\Assets\Scripts\BigSlimeControler.cs", "C#", 30, 2, 8, 40
"d:\Projekty\RoguelikeGame - Praca Inżynierska\roguelike-game\Roguelike Game Project\Assets\Scripts\BlueberriesControler.cs", "C#", 15, 2, 4, 21
"d:\Projekty\RoguelikeGame - Praca Inżynierska\roguelike-game\Roguelike Game Project\Assets\Scripts\BulletControler.cs", "C#", 45, 2, 8, 55
"d:\Projekty\RoguelikeGame - Praca Inżynierska\roguelike-game\Roguelike Game Project\Assets\Scripts\BulletFallControler.cs", "C#", 17, 2, 6, 25
"d:\Projekty\RoguelikeGame - Praca Inżynierska\roguelike-game\Roguelike Game Project\Assets\Scripts\CameraControler.cs", "C#", 40, 1, 10, 51
"d:\Projekty\RoguelikeGame - Praca Inżynierska\roguelike-game\Roguelike Game Project\Assets\Scripts\ChasingEnemy.cs", "C#", 59, 2, 10, 71
"d:\Projekty\RoguelikeGame - Praca Inżynierska\roguelike-game\Roguelike Game Project\Assets\Scripts\CoinControler.cs", "C#", 21, 2, 6, 29
"d:\Projekty\RoguelikeGame - Praca Inżynierska\roguelike-game\Roguelike Game Project\Assets\Scripts\DrawDungeon.cs", "C#", 12, 2, 5, 19
"d:\Projekty\RoguelikeGame - Praca Inżynierska\roguelike-game\Roguelike Game Project\Assets\Scripts\DungeonGenerator.cs", "C#", 6, 244, 2, 252
"d:\Projekty\RoguelikeGame - Praca Inżynierska\roguelike-game\Roguelike Game Project\Assets\Scripts\DungeonRoom.cs", "C#", 33, 2, 5, 40
"d:\Projekty\RoguelikeGame - Praca Inżynierska\roguelike-game\Roguelike Game Project\Assets\Scripts\EnemyControler.cs", "C#", 112, 2, 16, 130
"d:\Projekty\RoguelikeGame - Praca Inżynierska\roguelike-game\Roguelike Game Project\Assets\Scripts\GameControler.cs", "C#", 19, 1, 7, 27
"d:\Projekty\RoguelikeGame - Praca Inżynierska\roguelike-game\Roguelike Game Project\Assets\Scripts\GameOverScreen.cs", "C#", 20, 0, 4, 24
"d:\Projekty\RoguelikeGame - Praca Inżynierska\roguelike-game\Roguelike Game Project\Assets\Scripts\HealthControler.cs", "C#", 38, 1, 5, 44
"d:\Projekty\RoguelikeGame - Praca Inżynierska\roguelike-game\Roguelike Game Project\Assets\Scripts\InventoryControler.cs", "C#", 20, 2, 5, 27
"d:\Projekty\RoguelikeGame - Praca Inżynierska\roguelike-game\Roguelike Game Project\Assets\Scripts\ItemControler.cs", "C#", 23, 2, 10, 35
"d:\Projekty\RoguelikeGame - Praca Inżynierska\roguelike-game\Roguelike Game Project\Assets\Scripts\ItemPedestalControler.cs", "C#", 20, 2, 6, 28
"d:\Projekty\RoguelikeGame - Praca Inżynierska\roguelike-game\Roguelike Game Project\Assets\Scripts\Knockback.cs", "C#", 6, 0, 3, 9
"d:\Projekty\RoguelikeGame - Praca Inżynierska\roguelike-game\Roguelike Game Project\Assets\Scripts\LevelGeneration.cs", "C#", 204, 23, 14, 241
"d:\Projekty\RoguelikeGame - Praca Inżynierska\roguelike-game\Roguelike Game Project\Assets\Scripts\LoafOfBreadControler.cs", "C#", 16, 2, 4, 22
"d:\Projekty\RoguelikeGame - Praca Inżynierska\roguelike-game\Roguelike Game Project\Assets\Scripts\MagicTowerControler.cs", "C#", 43, 2, 10, 55
"d:\Projekty\RoguelikeGame - Praca Inżynierska\roguelike-game\Roguelike Game Project\Assets\Scripts\MagicTowerProjectile.cs", "C#", 43, 3, 8, 54
"d:\Projekty\RoguelikeGame - Praca Inżynierska\roguelike-game\Roguelike Game Project\Assets\Scripts\MapSpriteSelector.cs", "C#", 83, 0, 4, 87
"d:\Projekty\RoguelikeGame - Praca Inżynierska\roguelike-game\Roguelike Game Project\Assets\Scripts\PlayerControler.cs", "C#", 135, 9, 19, 163
"d:\Projekty\RoguelikeGame - Praca Inżynierska\roguelike-game\Roguelike Game Project\Assets\Scripts\Room.cs", "C#", 14, 0, 3, 17
"d:\Projekty\RoguelikeGame - Praca Inżynierska\roguelike-game\Roguelike Game Project\Assets\Scripts\RoomControler.cs", "C#", 244, 4, 23, 271
"d:\Projekty\RoguelikeGame - Praca Inżynierska\roguelike-game\Roguelike Game Project\Assets\Scripts\SandOfConceptionControler.cs", "C#", 15, 2, 4, 21
"d:\Projekty\RoguelikeGame - Praca Inżynierska\roguelike-game\Roguelike Game Project\Assets\Scripts\StartMenuControler.cs", "C#", 23, 2, 7, 32
"d:\Projekty\RoguelikeGame - Praca Inżynierska\roguelike-game\Roguelike Game Project\Assets\Scripts\StaticObstacleControler.cs", "C#", 17, 2, 6, 25
"d:\Projekty\RoguelikeGame - Praca Inżynierska\roguelike-game\Roguelike Game Project\Assets\Scripts\StrengthPotionControler.cs", "C#", 15, 2, 4, 21
"d:\Projekty\RoguelikeGame - Praca Inżynierska\roguelike-game\Roguelike Game Project\Assets\Scripts\ThunderControler.cs", "C#", 15, 2, 4, 21
"d:\Projekty\RoguelikeGame - Praca Inżynierska\roguelike-game\Roguelike Game Project\Assets\Scripts\UtilityBehaviors.cs", "C#", 11, 0, 2, 13
"d:\Projekty\RoguelikeGame - Praca Inżynierska\roguelike-game\Roguelike Game Project\Assets\Scripts\WallControler.cs", "C#", 21, 2, 6, 29
"Total", "-", 1445, 347, 244, 2036